24 30
9 9 9 9 9 9 9 9 9 9 9 9 9 9 9 9 9 9 9 9 9 9 9 9
9 9 9 9 9 9 9 9 9 5 3 3 3 6 9 9 9 9 9 9 9 9 9 9
9 9 9 9 9 9 9 9 12 0 0 0 10 0 15 9 9 9 9 9 9 9 9 9
9 9 9 9 9 9 9 12 0 0 0 0 10 10 0 15 9 9 9 9 9 9 9 9
9 9 9 9 9 9 12 0 0 10 0 0 0 10 0 0 15 9 9 9 9 9 9 9
9 9 9 9 9 12 0 0 10 0 33 34 35 0 10 0 0 15 9 9 9 9 9 9
9 9 9 9 9 12 0 10 10 37 38 39 40 41 0 0 0 15 9 9 9 9 9 9
9 9 9 9 9 12 0 10 0 42 43 44 45 46 0 0 10 15 9 9 9 9 9 9
9 9 9 9 9 12 0 0 0 47 48 49 51 52 0 0 0 15 9 9 9 9 9 9
9 9 9 9 9 9 12 0 0 53 54 55 56 57 0 0 15 9 9 9 9 9 9 9
9 9 9 9 9 9 9 12 0 0 60 61 62 0 0 15 9 9 9 9 9 9 9 9
9 9 9 9 9 9 9 9 12 0 0 0 10 0 15 9 9 9 9 9 9 9 9 9
9 9 9 9 9 9 9 9 9 9 12 0 15 9 9 9 9 9 9 9 9 9 9 9
9 9 9 9 9 9 9 9 9 9 12 0 15 9 9 9 9 9 9 9 9 9 9 9
9 9 9 9 9 9 9 9 9 9 12 0 15 9 9 9 9 9 9 9 9 9 9 9
9 9 9 9 9 9 9 9 9 9 12 0 15 9 9 9 9 9 9 9 9 9 9 9
9 9 9 9 9 9 9 9 9 9 12 0 15 9 9 9 9 9 9 9 9 9 9 9
9 9 9 9 9 9 9 9 9 9 12 0 15 9 9 9 9 9 9 9 9 9 9 9
9 9 9 9 9 9 9 9 9 9 12 0 15 9 9 9 9 9 9 9 9 9 9 9
9 9 9 9 9 9 9 9 9 9 12 0 15 9 9 9 9 9 9 9 9 9 9 9
9 9 9 9 9 9 9 9 9 9 12 10 15 9 9 9 9 9 9 9 9 9 9 9
9 9 9 9 9 9 9 9 9 9 12 10 15 9 9 9 9 9 9 9 9 9 9 9
9 9 9 9 9 9 9 9 9 9 12 10 15 9 9 9 9 9 9 9 9 9 9 9
9 9 9 9 9 9 9 9 9 9 12 0 15 9 9 9 9 9 9 9 9 9 9 9
9 9 9 9 9 9 9 9 9 9 12 0 15 9 9 9 9 9 9 9 9 9 9 9
9 9 9 9 9 9 9 9 9 12 0 0 0 15 9 9 9 9 9 9 9 9 9 9
9 9 9 9 9 9 9 9 12 0 0 0 0 0 15 9 9 9 9 9 9 9 9 9
9 9 9 9 9 9 9 12 0 0 0 0 0 10 0 15 9 9 9 9 9 9 9 9
9 9 9 9 9 9 12 0 10 10 0 0 0 0 0 0 15 9 9 9 9 9 9 9
9 9 9 9 9 12 0 10 10 0 0 0 0 0 0 10 0 15 9 9 9 9 9 9