24 30
30 25 25 25 25 25 25 25 25 25 31 5 3 3 3 3 3 3 3 3 3 3 3 6
23 27 27 27 27 27 27 27 27 27 26 12 0 10 0 0 0 0 0 0 0 0 0 15
23 27 27 27 27 27 27 27 27 27 26 12 10 0 0 0 0 0 0 0 0 0 0 15
23 27 27 27 27 27 27 27 27 27 27 0 0 0 0 0 0 0 0 0 0 0 0 15
23 27 27 27 27 27 27 27 27 27 27 0 0 0 0 0 0 0 0 0 10 0 0 15
23 27 27 27 27 27 27 27 27 27 26 12 0 0 0 0 0 0 0 0 0 0 0 15
28 24 24 24 24 24 24 24 24 24 29 12 0 0 0 0 0 0 0 0 0 0 0 15
5 3 3 3 3 3 3 3 3 3 3 0 0 0 0 0 0 0 0 0 0 0 0 15
12 0 0 0 0 0 0 0 0 0 0 0 0 0 0 0 0 0 0 10 0 0 0 15
12 0 0 0 0 0 0 0 0 0 0 0 0 0 0 0 0 0 0 0 0 0 0 15
12 0 0 0 0 0 0 0 0 0 0 0 0 10 0 0 0 0 0 0 0 0 0 15
12 2 2 2 2 2 2 2 2 2 2 2 2 2 2 2 2 2 2 2 2 2 2 15
12 0 0 0 0 0 0 0 0 0 0 0 10 0 0 0 0 0 0 0 0 0 0 15
12 0 0 0 0 0 0 0 0 0 0 0 0 0 0 0 0 0 0 0 0 0 0 15
12 0 0 0 0 0 0 0 10 32 33 34 35 36 10 0 0 0 0 0 0 0 0 15
12 0 0 0 0 10 0 0 0 37 38 39 40 41 0 0 0 0 0 0 0 0 0 15
12 0 0 0 0 0 10 0 58 42 43 44 45 46 59 0 0 0 0 0 0 0 0 15
12 0 2 2 2 2 0 0 0 47 48 49 51 52 10 0 0 0 2 2 2 2 10 15
12 0 0 0 0 0 0 0 10 53 54 55 56 57 0 0 0 0 0 0 0 0 0 15
12 0 0 0 0 0 0 0 10 10 60 61 62 0 0 0 0 0 0 0 0 10 0 15
12 0 0 0 0 0 0 0 0 0 0 0 10 0 0 0 0 0 0 0 0 0 10 15
12 10 10 0 0 0 0 0 0 0 0 0 0 0 0 0 0 0 0 0 0 0 0 15
12 0 10 0 0 0 0 0 0 0 0 0 0 0 0 0 0 0 0 0 0 0 0 15
12 2 2 2 2 2 2 2 2 2 2 2 2 2 2 2 2 2 2 2 2 2 2 15
12 0 0 0 0 0 0 0 0 0 0 0 0 0 0 0 0 0 0 0 0 0 0 15
12 0 0 0 0 0 0 0 0 0 0 0 0 0 0 0 0 0 0 0 0 10 0 15
12 0 0 0 10 10 0 0 0 0 0 0 0 0 0 0 0 0 0 0 0 0 0 15
18 1 1 1 1 1 1 1 1 1 1 1 1 1 1 1 1 1 0 0 0 1 1 19
4 13 14 13 13 14 13 13 14 13 13 14 13 13 14 13 13 14 13 13 14 13 13 7
4 4 7 4 4 7 4 4 7 4 4 7 4 4 7 4 4 7 4 4 7 4 4 7