24 30
5 3 3 3 3 3 3 3 3 3 6 5 3 3 3 3 3 3 3 3 3 3 3 6
12 0 0 0 0 0 0 0 0 0 15 12 0 10 0 0 0 0 0 0 0 0 0 15
12 0 0 0 0 0 0 0 0 0 15 12 10 0 0 0 0 0 0 0 0 0 0 15
12 0 0 0 0 0 0 0 0 0 0 0 0 0 0 0 0 0 0 0 0 0 0 15
12 0 0 0 0 0 0 0 0 0 0 0 0 0 0 0 0 0 0 0 0 0 0 15
12 0 0 0 0 0 0 0 0 0 15 12 0 0 0 0 0 0 0 0 0 0 0 15
12 0 0 0 0 0 0 0 0 0 15 12 2 2 2 2 2 2 2 2 2 2 2 15
12 0 0 0 0 0 0 0 0 0 15 12 0 0 0 0 0 0 0 0 0 0 0 15
12 0 0 0 0 0 0 0 0 0 15 12 0 0 0 0 0 0 0 0 0 0 0 15
12 0 0 0 0 0 0 0 0 0 15 12 0 0 0 0 0 0 0 0 0 0 0 15
12 0 0 0 0 0 0 0 0 0 15 12 0 10 0 0 0 0 0 0 0 0 0 15
12 0 0 0 0 0 0 0 0 0 15 12 0 0 0 0 0 0 0 0 0 0 0 15
12 0 0 0 0 0 0 0 0 0 15 12 10 0 0 0 0 0 0 0 0 0 0 15
12 0 0 0 0 0 0 0 0 0 15 12 0 0 0 0 0 0 0 17 0 0 0 15
12 0 0 0 0 0 0 0 0 0 15 12 0 0 0 0 0 0 0 0 0 0 0 15
12 0 0 0 0 0 0 0 0 0 15 12 0 0 0 0 0 0 0 0 0 0 0 15
12 0 0 0 0 0 0 0 0 0 15 12 0 0 0 0 0 0 0 0 0 0 0 15
12 0 0 0 0 0 0 0 0 0 15 12 0 0 0 0 0 0 0 0 0 0 10 15
12 0 0 0 0 0 0 0 0 0 15 12 0 0 0 0 0 0 0 0 0 0 0 15
12 0 0 0 0 0 0 0 0 0 15 12 0 0 0 0 0 0 0 0 0 10 0 15
12 0 0 0 0 0 0 0 0 0 15 12 0 0 0 0 0 0 0 0 0 0 10 15
12 0 0 0 0 0 0 0 0 0 15 12 0 0 0 0 0 0 0 0 0 0 0 15
12 0 0 0 0 0 0 0 0 0 15 12 0 0 0 0 0 0 0 0 0 0 0 15
12 0 0 0 0 0 0 0 0 0 15 12 2 2 2 2 2 2 2 2 2 2 2 15
12 0 0 0 0 0 0 0 0 0 15 12 0 0 0 0 0 0 0 0 0 0 0 15
12 0 0 0 0 0 0 0 0 0 15 12 0 0 0 0 0 0 0 0 0 0 0 15
12 0 0 0 0 0 0 0 0 0 15 12 0 0 0 0 0 0 0 0 0 0 0 15
18 1 1 1 1 1 1 1 1 1 19 18 1 1 1 1 1 1 0 0 0 1 1 19
4 13 14 13 13 14 13 13 14 13 13 14 13 13 14 13 13 14 13 13 14 13 13 7
4 4 7 4 4 7 4 4 7 4 4 7 4 4 7 4 4 7 4 4 7 4 4 7