17 12
5 3 3 3 3 3 3 3 3 3 3 3 3 3 3 3 6
12 8 8 8 8 8 8 8 8 8 8 8 8 8 8 8 15
12 0 10 10 0 0 0 0 0 0 0 0 0 0 0 0 15
12 0 10 10 0 0 0 0 0 0 0 0 0 10 10 0 15
12 0 0 0 0 0 0 0 0 0 0 0 10 10 10 0 15
12 0 0 0 0 0 0 17 0 0 0 0 10 10 10 0 15
12 2 2 2 2 2 2 2 2 2 2 2 2 2 2 2 15
12 0 0 0 0 0 0 0 0 0 0 0 0 0 0 0 15
12 0 0 0 0 0 0 0 0 0 0 0 0 0 0 0 15
12 0 0 0 0 0 0 0 0 0 0 0 10 0 0 0 15
12 8 8 8 8 8 8 8 8 8 8 8 8 8 8 8 15
18 1 1 1 1 1 1 1 1 1 1 1 1 1 1 1 19